My Singing Monsters monster filenames
+_RARE/+_EPIC means that the monster is rare or epic
It seems that some of these monsters are from DoF
A - Tweedle
AB - Dandidoo
ABC - Reedling
ABCD - Shellbeat
ABCDN - Candelavra
ABCE - Quarrister
ABCEN - Drummidary
ABCN - Tring
ABD - Spunge
ABDE - Deedge
ABDEN - Bowhead
ABDN - Bisonorus
ABE - Thumpies
ABEN - Yelmut
ABN - Barrb
AC - Cybop
ACD - Scups
ACDE - Riff
ACDEN - unknown, maybe unreleased.
ACDN - Flum Ox
ACE - PomPom
ACEN - Krillby
ACN - Floogull
AD - Quibble
ADE - unknown, I feel like I know this one but I forgot it's name.
ADEN - Sneyser
ADN - Whaddle
AE - Pango
AEN - Woolable
AN - Glowl
B - Potbelly
BC - Shrubb
BCD - Pummel
BCDE - Entbrat
BCDN - Edamimi
BCE - Clamble
BCEN - PongPing
BCN - Repatillio
BD - Oaktopus
BDE - Bowgart
BDEN - Incisaur
BDN - Rootitoot
BDNR - Gloptic
BDR - Tapricorn
BE - Furcorn
BEN - Sooza
BENW - Blow't
BEW - Spytrap
BN - Flowah
BNR - Rooba
BNW - unknown
BR - Bonkers
BUDDY - Glowbe
BUDDY_top - the top of Glowbe
BW - Gob
C - Noggin
CD - Fwog
CDE - T-rox
CDEN - Tiawa
CDN - Thrumble
CDNV - Plinkadou
CDV - Withur
CE - Drumpler
CEN - Ziggurab
CENY - Pladdie
CEY - unknown
CN - Stogg
CNV - Uuduk
CNY - Bridg-It
CV - Peckidna
CY - HippityHop
D - Toe Jammer
DE - Maw
DEN - Wynq
DN - Phangler
DNR - Pariscorp
DNV - Banjaw
DR - Poppette
DV - Denchuhs
E - Mammot
EN - Boskus
ENW - Fiddlement
ENY - unknown
EW - Cataliszt
EY - Squot
F - Wubbox
G - Ghazt
GJ - Whisp
GK - Nebulob
GL - Sox
GM - Jellbilly
J - Grumpyre
JK - Arackulele
JL - Boodoo
JM - Kazzileon
K - Reebro
KL - Bellowfish
KM - Dragong
L - Jeeode
LM - Fung Pray
M - Humbug
N - Kanya
NR - Yuggler
NV - Hawlo
NW - Pluckbill
NY - Wimmzies
P01 - Yawstrich
P02 - G'Joob
P03 - Strombonin
P04 - Cherubble
P05 - Hyehehe
P08 - Cataliszt
P09 - Sporerow
P10 - Bleatnik
P11 - Cranchee
P12 - shLep
P13 - unknown
R - Theremind
